ô kêi	ok
okie	ok
o kê	ok
okey	ok
ôkê	ok
oki	ok
oke	ok
okay	ok
okê	ok
tks	cám ơn
thks	cám ơn
thanks	cám ơn
ths	cám ơn
thank	cám ơn
⭐	star
*	star
🌟	star
kg	không
not	không
kg	không
"k	không
kh	không
kô	không
hok	không
kp	không phải
kô	không
"ko	không
ko	không
k	không
khong	không
hok	không
he he	haha
hehe	haha
hihi	haha
haha	haha
hjhj	haha
lol	haha
cute	dễ thương
huhu	nagative
vs	với
wa	quá
wá	quá
j	gì
“	
sz	cỡ
size	cỡ
đx	được
dk	được
dc	được
đk	được
đc	được
authentic	chuẩn chính hãng
aut	chuẩn chính hãng
auth	chuẩn chính hãng
thick	thích
store	cửa hàng
shop	cửa hàng
sp	sản phẩm
gud	tốt
god	tốt
wel done	tốt
good	tốt
gút	tốt
sấu	xấu
gut	tốt
tot	tốt
nice	tốt
perfect	rất tốt
bt	bình thường
time	thời gian
qá	quá
ship	giao hàng
m	mình
mik	mình
ể	ể
product	sản phẩm
quality	chất lượng
excelent	hoàn hảo
bad	tệ
fresh	tươi
sad	tệ
date	hạn sử dụng
hsd	hạn sử dụng
quickly	nhanh
quick	nhanh
fast	nhanh
delivery	giao hàng
síp	giao hàng
beautiful	đẹp tuyệt vời
tl	trả lời
r	rồi
like	thích
shopE	cửa hàng
order	đặt hàng
chất lg	chất lượng
sd	sử dụng
dt	điện thoại
nt	nhắn tin
t	tôi
sài	xài
bjo	bao giờ
thik	thích
sop	cửa hàng
fb	facebook
face	facebook
very	rất
quả ng	quảng
dep	đẹp
xau	xấu
delicious	ngon
hàg	hàng
qủa	quả
iu	yêu
fake	giả mạo
trl	trả lời
por	tệ
poor	tệ
ib	nhắn tin
rep	trả lời
fback	feedback
fedback	feedback
6 sao	5star
6 star	5star
5star	5star
5 sao	5star
5sao	5star
starstarstarstarstar	5star
1 sao	1star
1sao	1star
2 sao	1star
2sao	1star
2 starstar	1star
1star	1star
0 sao	1star
0star	1star
