òa	oà
óa	oá
ỏa	oả
õa	oã
ọa	oạ
òe	oè
óe	oé
ỏe	oẻ
õe	oẽ
ọe	oẹ
ùy	uỳ
úy	uý
ủy	uỷ
ũy	uỹ
ụy	uỵ
uả	ủa
ả	ả
ố	ố
u´	ố
ỗ	ỗ
ồ	ồ
ổ	ổ
ấ	ấ
ẫ	ẫ
ẩ	ẩ
ầ	ầ
ỏ	ỏ
ề	ề
ễ	ễ
ắ	ắ
ủ	ủ
ế	ế
ở	ở
ỉ	ỉ
ẻ	ẻ
aˋ	à
iˋ	ì
ă´	ắ
ử	ử
e˜	ẽ
y˜	ỹ
a´	á
